Albaania: Balkani poolsaar
Andorra: Mägine printsiriik
Armeenia: Kaukaasia mäed
Aserbaidžaan: Kaspia mere ääres
Austria: Alpid ja Mozart
Belgia: Šokolaad ja friikartulid
Bosnia ja Hertsegoviina: Sarajevo ja Mostar
Bulgaaria: Must meri ja Roosimaa
Eesti: Balti pärl
Gruusia: Kaukaasia kultuur
Hispaania: Flamenco ja Alhambra
Holland: Tuulikud ja kanalid
Horvaatia: Adriamaa rannik
Iirimaa: Roheline saar
Island: Geisrid ja vulkaanid
Itaalia: Kaardil jalakujuline
Kreeka: Antiikne tsivilisatsioon
Küpros: Mereäärne saar
Leedu: Balti ajalugu
Luksemburg: Väike ja rikkalik
Läti: Balti kultuur
Madalmaad: Tuulikud ja jalgrattad
Malta: Vahemere pärl
Poola: Rikkalik ajalugu
Portugal: Portvein ja fado
Prantsusmaa: Eiffeli torn ja vein
Rootsi: Metsad ja järved
Rumeenia: Dracula ja Karpaadid
Saksamaa: Oktoberfest ja tehnoloogia
Sloveenia: Alpid ja Postojna koobas