Albaania: Balkani poolsaar
Andorra: Mägine printsiriik
Armeenia: Kaukaasia mäed
Aserbaidžaan: Kaspia mere ääres
Gruusia: Kaukaasia kultuur
Hispaania: Flamenco ja Alhambra
Island: Geisrid ja vulkaanid
Jaapan: Sakura õied
Keenia: Savannid ja metsik loodus
Kolumbia: Amazonase vihmametsad
Malaisia: Eksootilised saared
Maroko: Värvikas kultuur
Peruu: Inkade impeerium
Türgi: Siluett Bosporuse ääres
Vietnam: Halongi laht ja riisiterrassid
Moldova: Veinikeldrid
Montenegro: Adriamaa rannik
Põhja-Makedoonia: Ohridi järv
Serbia: Belgradi kindlus
Afganistan: Hindukuš ja kultuuriline pärand
Alžeeria: Sahara kõrb
Ameerika Ühendriigid: Grand Canyoni rahvuspark
Andorra: Mägine printsiriik
Angola: Victoria juga
Araabia Ühendemiraadid: Luksuslikud pilvelõhkujad
Argentina: Tango ja Patagoonia
Armeenia: Kaukaasia mäed
Aserbaidžaan: Kaspia mere ääres
Austria: Alpid ja Mozart
Belgia: Šokolaad ja friikartulid